Imaginons	VER:pres	imaginer
le	DET:ART	le
montage	NOM	montage
juridique	ADJ	juridique
suivant	VER:ppre	suivre
:	PUN	:
des	PRP:det	du
propriétaires	NOM	propriétaire
d’hôtels	ADJ	d’hôtels
se	PRO:PER	se
regroupent	VER:pres	regrouper
et	KON	et
créent	VER:pres	créer
une	DET:ART	un
plate-forme	NOM	plate-forme
commune	ADJ	commun
via	PRP	via
une	DET:ART	un
société	NOM	société
établie	VER:pper	établir
en	PRP	en
Irlande	NAM	Irlande
par	PRP	par
exemple	NOM	exemple
.	SENT	.
L’outil	NOM	L’outil
informatique	ADJ	informatique
met	VER:pres	mettre
en	PRP	en
relation	NOM	relation
des	PRP:det	du
clients	NOM	client
et	KON	et
les	DET:ART	le
propriétaires	ADJ	propriétaire
d’hôtels	NOM	d’hôtels
moyennant	PRP	moyennant
un	DET:ART	un
pourcentage	NOM	pourcentage
sur	PRP	sur
le	DET:ART	le
prix	NOM	prix
de	PRP	de
chaque	PRO:IND	chaque
chambre	NOM	chambre
louée	VER:pper	louer
.	SENT	.
Ces	PRO:DEM	ce
hôteliers	NOM	hôtelier
sous-traitent	VER:pres	sous-traiter
l’ensemble	ADJ	l’ensemble
de	PRP	de
leurs	DET:POS	leur
activités	NOM	activité
–	PUN	–
réception	NOM	réception
,	PUN	,
gestion	NOM	gestion
,	PUN	,
entretien	NOM	entretien
des	PRP:det	du
locaux	NOM	local
,	PUN	,
ménage	NOM	ménage
–	PUN	–
à	PRP	à
des	PRP:det	du
autoentrepreneurs	NOM	autoentrepreneurs
non	ADV	non
exclusivement	ADV	exclusivement
attachés	VER:pper	attacher
à	PRP	à
un	DET:ART	un
établissement	NOM	établissement
.	SENT	.
Ils	PRO:PER	il
font	VER:pres	faire
,	PUN	,
ensuite	ADV	ensuite
,	PUN	,
que	KON	que
le	DET:ART	le
prix	NOM	prix
reversé	VER:pper	reverser
par	PRP	par
la	DET:ART	le
plate-forme	NOM	plate-forme
soit	VER:subp	être
d’un	ADJ	d’un
tel	PRO:DEM	tel
niveau	NOM	niveau
que	PRO:REL	que
,	PUN	,
après	PRP	après
déduction	NOM	déduction
des	PRP:det	du
frais	ADJ	frais
,	PUN	,
seul	ADJ	seul
un	DET:ART	un
faible	ADJ	faible
bénéfice	NOM	bénéfice
est	VER:pres	être
réalisé	VER:pper	réaliser
en	PRP	en
France	NAM	France
.	SENT	.
Il	PRO:PER	il
n’y	NOM	n’y
a	VER:pres	avoir
alors	ADV	alors
quasiment	ADV	quasiment
plus	ADV	plus
d’assiette	NOM	d’assiette
à	PRP	à
cotisations	NOM	cotisation
sociales	ADJ	social
dans	PRP	dans
notre	DET:POS	notre
pays	NOM	pays
.	SENT	.
Les	DET:ART	le
propriétaires	ADJ	propriétaire
d’hôtels	NOM	d’hôtels
seraient	VER:cond	être
évidemment	ADV	évidemment
rémunérés	VER:pper	rémunérer
sous	PRP	sous
forme	NOM	forme
de	PRP	de
dividendes	NOM	dividende
de	PRP	de
la	DET:ART	le
société	NOM	société
irlandaise	ADJ	irlandais
.	SENT	.
Fiction	NOM	fiction
évidemment	ADV	évidemment
:	PUN	:
les	DET:ART	le
hôteliers	NOM	hôtelier
en	PRP	en
question	NOM	question
devraient	VER:cond	devoir
d’abord	NOM	d’abord
réussir	VER:infi	réussir
à	PRP	à
licencier	VER:infi	licencier
...	PUN	...
