Par	PRP	par
Olivier	NAM	Olivier
Levrault	NAM	Levrault
Si	VER:futu	Si
les	DET:ART	le
comportements	NOM	comportement
homosexuels	ADJ	homosexuel
sont	VER:pres	être
très	ADV	très
répandus	VER:pper	répandre
chez	PRP	chez
les	DET:ART	le
animaux	NOM	animal
,	PUN	,
ils	PRO:PER	il
sont	VER:pres	être
longtemps	ADV	longtemps
restés	VER:pper	rester
tabous	NOM	tabou
dans	PRP	dans
le	DET:ART	le
monde	NOM	monde
scientifique	ADJ	scientifique
.	SENT	.
Jusqu’à	ABR	Jusqu’à
ce	PRO:DEM	ce
qu’en	NOM	qu’en
1999	NUM	@card@
le	DET:ART	le
biologiste	NOM	biologiste
Bruce	NAM	Bruce
Bagemihl	NAM	Bagemihl
les	PRO:PER	la|le
répertorie	VER:pres	répertorier
dans	PRP	dans
450	NUM	@card@
espèces	NOM	espèce
.	SENT	.
Le	DET:ART	le
chercheur	NOM	chercheur
canadien	ADJ	canadien
laissait	VER:impf	laisser
cependant	ADV	cependant
en	PRP	en
suspens	ADJ	suspens
une	DET:ART	un
question	NOM	question
fondamentale	ADJ	fondamental
:	PUN	:
pourquoi	ADV	pourquoi
les	DET:ART	le
animaux	NOM	animal
présentent	VER:pres	présenter
-ils	PRO:PER	il
des	PRP:det	du
comportements	NOM	comportement
n’apportant	NOM	n’apportant
a	VER:pres	avoir
priori	ADV	priori
aucun	PRO:IND	aucun
avantage	NOM	avantage
d’un	ADJ	d’un
point	NOM	point
de	PRP	de
vue	NOM	vue
évolutionniste	ADJ	évolutionniste
,	PUN	,
puisqu’ils	NOM	puisqu’ils
ne	ADV	ne
concourent	VER:pres	concourir
pas	ADV	pas
à	PRP	à
la	DET:ART	le
reproduction	NOM	reproduction
?	SENT	?
Des	PRP:det	du
scientifiques	ADJ	scientifique
de	PRP	de
l’université	NOM	l’université
d’Uppsala	VER:simp	d’Uppsala
,	PUN	,
en	PRP	en
Suède	NAM	Suède
,	PUN	,
apportent	VER:pres	apporter
une	DET:ART	un
partie	NOM	partie
de	PRP	de
la	DET:ART	le
réponse	NOM	réponse
,	PUN	,
grâce	NOM	grâce
aux	PRP:det	au
bruches	NOM	bruches
,	PUN	,
des	PRP:det	du
insectes	NOM	insecte
de	PRP	de
la	DET:ART	le
famille	NOM	famille
des	PRP:det	du
coléoptères	NOM	coléoptère
.	SENT	.
Selon	PRP	selon
leur	DET:POS	leur
étude	NOM	étude
,	PUN	,
publiée	VER:pper	publier
vendredi	NOM	vendredi
13	NUM	@card@
mai	NOM	mai
dans	PRP	dans
la	DET:ART	le
revue	NOM	revue
BMC	NAM	BMC
Evolutionary	NAM	Evolutionary
Biology	NAM	Biology
,	PUN	,
le	DET:ART	le
comportement	NOM	comportement
homosexuel	ADJ	homosexuel
des	PRP:det	du
bruches	NOM	bruches
mâles	ADJ	mâle
va	VER:pres	aller
de	PRP	de
pair	NOM	pair
avec	PRP	avec
une	DET:ART	un
plus	ADV	plus
grande	ADJ	grand
fécondité	NOM	fécondité
des	PRP:det	du
femelles	NOM	femelle
.	SENT	.
«	PUN:cit	«
Certains	ADJ	certain
gènes	NOM	gène
augmentant	VER:ppre	augmenter
la	DET:ART	le
fécondité	NOM	fécondité
des	PRP:det	du
bruches	NOM	bruches
femelles	ADJ	femelle
conduisent	VER:pres	conduire
à	PRP	à
une	DET:ART	un
fréquence	NOM	fréquence
plus	ADV	plus
élevée	VER:pper	élever
des	PRP:det	du
comportements	NOM	comportement
sexuels	ADJ	sexuel
...	PUN	...
